S                                      #
######################################H#
#                                      ####
############################## ############
#                              #          #
#  #############################          #                              H
#                                         #
#                                         #
#########################################
                                        ##
######################################### #
EH                                        #
# #################################################################################################
# #
# # #################################################################################################
# # #
# # #
# # #
# # #
# # ######################
# #                      #
# ##################### ##
#                       ##
                      # ###########################################
                      # #
                      # #
                      # #
                      # #
                      # #
                      # #
                      # #
                      # #
                      # #
                      # #
                      # #
                      #